00000000000000000000000000
00000000000000000000000000
00000000000000000000000000
22222222222222222222222222
22222222222222222222222222
00001100110000001111100000
00001100110000001101110000
00001100110000001100011000
22221111110033001100011222
00001100110000001100011000
00001100110000001101110000
00001100110000001111100000
22222222222222222222222222
22222222222222222222222222
33333330000000000000000000
11111110000000000000000000
00000000000000111111000000
00000000333333000001000000
11111100100033000002000000
11111100100000000002000000
00000000100000000003111113
00000000100000000000000000
00000111100000000000000000
11122000000111100000000111
67122000000167100000000167
89100000000189100000000189